1,1,1,1,1,1,1,1,1,1,1,1,1,1,36,37,1,1,1,1
1,1,1,1,1,1,1,1,1,1,1,1,1,1,44,45,1,1,1,1
1,13,1,1,1,1,1,1,1,1,1,1,1,1,1,1,8,8,8,8
1,1,1,1,1,1,1,1,1,1,1,1,1,1,1,1,8,8,8,8
1,1,1,13,1,1,1,1,1,1,1,1,1,1,1,1,8,8,8,8
9,9,9,1,1,1,1,1,1,1,1,1,1,1,1,1,8,8,8,8
9,9,9,1,1,1,1,1,1,1,1,1,1,1,1,1,1,1,1,1
1,1,1,1,1,1,1,1,1,1,1,1,1,1,1,1,1,1,1,1
1,1,1,1,1,1,1,1,1,1,1,1,1,1,1,1,1,1,1,1
1,1,1,1,1,1,1,1,1,1,1,1,1,1,1,1,1,1,1,1
1,28,1,1,1,1,1,1,1,1,1,1,1,1,1,1,1,13,1,1
1,1,1,1,1,1,1,1,1,1,1,1,1,1,1,1,1,1,1,1
1,1,1,1,1,1,1,1,1,1,1,1,1,1,1,1,1,1,1,1
12,12,12,12,12,12,12,12,12,12,12,12,12,12,12,12,12,12,12,12
12,12,12,12,12,12,12,12,12,12,12,12,12,12,12,12,12,12,12,12
