83,83,83,83,83,83,83,83,83,83,83,83,83,83,83,83,83,83,83,83
83,83,83,83,83,83,1,1,1,1,1,1,1,1,1,1,1,1,1,83
83,83,83,83,83,83,1,1,1,1,1,1,1,1,1,1,1,1,1,83
83,83,83,83,83,83,83,83,1,1,83,83,83,83,83,83,83,1,1,83
83,83,83,83,83,83,83,83,1,1,83,83,83,83,83,83,83,1,1,83
83,83,83,83,83,83,83,83,1,1,83,83,83,83,83,83,83,1,1,83
83,83,83,83,1,1,1,1,1,1,83,83,1,1,83,83,83,1,1,83
83,83,83,83,1,1,1,1,1,1,83,83,1,1,1,83,83,1,1,83
83,83,83,83,1,1,1,83,83,83,83,83,1,1,1,83,83,1,1,83
83,83,83,83,1,1,1,83,83,83,83,83,1,1,1,83,83,1,1,83
83,83,83,83,1,1,1,1,1,1,1,1,1,1,1,83,83,1,1,83
83,83,83,83,1,1,1,1,1,1,1,1,1,1,1,83,83,1,1,83
83,83,83,83,1,1,1,1,1,1,1,1,1,1,1,83,83,1,1,83
83,83,83,83,83,83,83,83,83,83,83,83,83,83,83,83,83,1,1,83
83,83,83,83,83,83,83,83,83,83,83,83,83,83,83,83,83,1,1,83
